
What's he going to say?	    वह क्या कहने जा रहा है?
Maybe we should tell him before he sees it.	    शायद हमें उसे देखने से पहले उसे बताना चाहिए।
He saw it.	    उसने इसे देखा।
How could he see it? I was the first one up; he was still in bed.	   वह इसे कैसे देख सकता था?मैं पहला था;वह अभी भी बिस्तर में था।
He was out here when it broke.	    जब वह टूट गया तो वह यहां से बाहर था।
When?	कब?
Four o clock this morning. I heard a crack and I woke up and looked out. He was standing right over there when it cracked.	    आज सुबह चार ओ घड़ी।मैंने एक दरार सुनी और मैं जाग गया और बाहर देखा।जब वह टूट गया तो वह वहीं खड़ा था।
What was he doing out here at four o clock in the morning?	    वह सुबह चार ओ घड़ी में यहाँ क्या कर रहा था?
I don't know.	    मुझें नहीं पता।
He's dreaming of him again, walking around.	    वह फिर से उसका सपना देख रहा है, घूम रहा है।
I guess he is.	    मुझे लगता है कि वह है।
It's getting to be just like after he died. What's the meaning of that?	    मरने के बाद ही ऐसा ही हो रहा है।उस का अर्थ क्या है?
I don't know the meaning of it. But I know one thing, Mom, you've made a terrible mistake with father.	    मैं इसका अर्थ नहीं जानता।लेकिन मुझे एक बात पता है, माँ, आपने पिता के साथ एक भयानक गलती की है।
What?	क्या?
Being dishonest with him, you know. This kind of thing always pays off and it's paying off.	    उसके साथ बेईमान होने के नाते, आप जानते हैं।इस तरह की बात हमेशा भुगतान करती है और यह भुगतान कर रही है।
What do you mean dishonest?	    आपका क्या मतलब है बेईमान?
You know Larry is not coming back and I know it. Why do we allow him to go on thinking that we believe with him?	    आप जानते हैं कि लैरी वापस नहीं आ रही है और मुझे पता है।हम उसे यह सोचकर जाने की अनुमति क्यों देते हैं कि हम उसके साथ विश्वास करते हैं?
What do you want to do? Argue with him?	    आप क्या करना चाहते हैं?उसके साथ बहस?
I don't want to argue but it's time he realized that nobody believes Larry is alive.	    मैं बहस नहीं करना चाहता, लेकिन यह समय है कि उसे एहसास हुआ कि कोई भी मानता है कि लैरी जीवित है।
You know? Why shouldn't he walk the nights thinking of him, dreaming of him?  Do we contradict him? Do we say, we don't have any hope anymore? That we haven't had any hope for years now?	        आपको पता है?वह उसके बारे में सोचते हुए रातों को क्यों नहीं चलना चाहिए, उसका सपना देख रहा है?क्या हम उसका खंडन करते हैं?क्या हम कहते हैं, हमें अब कोई उम्मीद नहीं है?कि हमें अब सालों से कोई उम्मीद नहीं है?
You can't say that to him.	    आप उससे ऐसा नहीं कह सकते।
We've got to say it to him.	    हम उसे उससे कहने के लिए मिल गए हैं।
Where's the proof? Do you have any proof?   	सबूत कहाँ है?क्या आपके पास कोई सबूत है?
For God's sake, three years? Nobody comes back after three years; that's insane.	    भगवान के लिए, तीन साल?तीन साल बाद कोई भी वापस नहीं आता है;यह पागलपन है।
To you it is, to me it is, but to your father, you can talk yourself until you are blue in the face. But there is no grave and there is no body, so where are you?	    आपके लिए यह है, मेरे लिए यह है, लेकिन अपने पिता के लिए, आप अपने आप से बात कर सकते हैं जब तक कि आप चेहरे पर नीले न हों।लेकिन कोई कब्र नहीं है और कोई शरीर नहीं है, तो आप कहाँ हैं?
Sit down, Mom. I want to talk to you.	    बैठो, माँ।मुझे आपसे बात करनी है।
It's that the trouble is those God damn newspapers. Every month some new boy comes back and so the next one is going to be Larry, they just--	    यह है कि मुसीबत उन भगवान लानत अखबारों है।हर महीने कुछ नया लड़का वापस आता है और इसलिए अगला एक लैरी होने जा रहा है, वे बस-
All right, all right, all right. You know why I asked Annie here, right?	    सब ठीक है, सब ठीक है, सब ठीक है।तुम्हें पता है कि मैंने एनी से यहाँ क्यों पूछा, है ना?
Why?	क्यों?
You know.	आपको पता है।
Well I got an idea, but what's your story?	    वैसे मुझे एक विचार मिला, लेकिन आपकी कहानी क्या है?
I'm going to ask her to marry me.	    मैं उससे शादी करने के लिए कहने जा रहा हूं।
Well that's only your business, Chris.	    वैसे यह केवल आपका व्यवसाय है, क्रिस।
You know it's not just my business.	    तुम्हें पता है कि यह सिर्फ मेरा व्यवसाय नहीं है।
Well what do you want me to do? You're old enough to know your own mind.	    वैसे आप मुझे क्या करना चाहते हैं?आप अपने मन को जानने के लिए काफी पुराने हैं।
So all right then, I'll just go ahead with it?	    तो सब ठीक है, तो मैं बस इसके साथ आगे बढ़ूंगा?
Well you want to make sure that your father is not going to --	    वैसे आप यह सुनिश्चित करना चाहते हैं कि आपके पिता नहीं जा रहे हैं -
Then it's not just my business.	    तब यह सिर्फ मेरा व्यवसाय नहीं है।
I'm just saying.	    मैं सिर्फ इतना कह रहा हूँ।
You know sometimes you infuriate me. you know that? Isn't it your business if I tell father and he throws a fit about it? God, you have such a talent for ignoring things.	    आप जानते हैं कि कभी -कभी आप मुझे प्रभावित करते हैं।आप जानते हैं कि?क्या यह आपका व्यवसाय नहीं है अगर मैं पिता को बताता हूं और वह इसके बारे में एक फिट फेंकता है?भगवान, आपके पास चीजों को अनदेखा करने के लिए ऐसी प्रतिभा है।
Oh. I ignore what I got to ignore. That girl is Larry's girl.	    ओह।मैं अनदेखा करता हूं कि मुझे क्या अनदेखा करना है।वह लड़की लैरी की लड़की है।
She's not Larry's girl.	    एफ: लाइन।
F: Line.	M:  माँ के दृष्टिकोण से, वह मर नहीं है।
M: From mother's point of view, he's not dead.	    अपने पिता के दृष्टिकोण से, वह मर नहीं है और- क्रिस वह अभी भी सोचता है कि वह अभी भी जीवित है।लड़की लैरी की लड़की है।
From your father's point of view, he is not dead and- Chris he still thinks he's still alive. The girl is Larry's girl.	F: से ... लाइन।
F: From...line.	M: अब आप यहाँ से जा सकते हैं।
M: Now you can go on from here.	अब आप वहां से जा सकते हैं यदि आप जानते हैं कि कहां जाना है, लेकिन मैं आपको बता रहा हूं, मुझे नहीं पता कि कहां जाना है।
Now you can go on from there if you know where to go, but I'm telling you, I don't know where to go.	मुझे नहीं पता कि यह क्यों है, लेकिन हर बार जब मैं किसी चीज़ के लिए पहुंचता हूं तो मुझे वापस खींचने के लिए क्योंकि मुझे डर है कि अन्य लोग पीड़ित होंगे।मेरा पूरा खूनी जीवन, समय के बाद समय।
I don't know why it is, but every time I reach out for something I have to pull back because I am afraid other people will suffer. My whole bloody life, time after time.	F: आप -
F: You're --	आप एक विचारशील साथी हैं, इसमें कुछ भी गलत नहीं है।
You're a considerate fellow, there's nothing wrong in that.	उस के साथ नरक के लिए।
To hell with that.	मैं अभी नहीं देखता।क्या आपने अभी तक एनी से पूछा है?
I just don't see why. Have you asked Annie yet?	मैं पहले इसे बसाना चाहता था।
I wanted to get this settled first.	वैसे आप कैसे जानते हैं कि वह आपसे शादी करने जा रही है?हो सकता है कि वह उसी तरह से महसूस करती है जिस तरह से आपके पिता करते हैं।
Well how do you know she's going to marry you? Maybe she feels the same way your father does.	खैर अगर वह करती है, तो यह बात है।यह इसका अंत है।उसके पत्रों से, हालांकि, मुझे लगता है कि वह उसे बहुत भूल गई है।
Well if she does, then that's it. That's the end of it. From her letters, though, I think she's pretty much forgotten him.	और फिर हम इसे पिता के साथ बाहर निकाल देंगे।ठीक है माँ?मुझसे न बचें।
And then we'll thrash it out with father. Okay Mom? Don't avoid me.	मुसीबत यह है कि आप पर्याप्त महिलाओं को नहीं देखते हैं।आपने कभी नहीं किया था।
The trouble is you don't see enough women. You never did.	तो क्या हुआ।मैं महिलाओं के साथ तेज नहीं हूं।
So what. I'm not fast with women.	यह एनी क्यों होना है?
Why does it have to be Annie?	इसलिए यह है।
Because it is.	ओह, यह एक महान कारण है।यह कोई कारण नहीं है।
Oh that's a great reason. It's no reason at all.	मुझें नहीं पता।
I don't know.	जब से आप युद्ध में चले गए, तब से आपने उसे नहीं देखा, पांच साल हो गए।
You haven't seen her since you went away to war, it's been five years.	मैं इसकी मदद नहीं कर सकता, मैं उसे सबसे अच्छा जानता हूं।मुझे उसके अगले दरवाजे पर लाया गया, आप जानते हैं?इन वर्षों में जब मैं अपनी पत्नी के लिए किसी के बारे में सोचता हूं, तो मैं एनी के बारे में सोचता हूं।
I can't help it, I know her best. I was brought up next door to her, you know? These years when I think of someone for my wife, I think of Annie.	माँ, तुम क्या चाहते हो?एक आरेख?
Mom, what do you want? A diagram?	मुझे एक आरेख नहीं चाहिए।
I don't want a diagram.	वह सोचता है कि वह क्रिस वापस आ रहा है।
He thinks he's coming back Chris.	आप उस लड़की से शादी करते हैं, आप उसे मृत घोषित कर रहे हैं ...
You marry that girl, you are pronouncing him dead...	सब ठीक है, फिर, माँ।[साँस लेने]
All right, then, Mom. [BREATHING]	बस इसे कुछ और सोचा।
Just give it some more thought.	मैंने इसे तीन साल का विचार दिया है।और मुझे उम्मीद है कि अगर मैं इंतजार कर रहा हूं, तो पिता लैरी के बारे में भूल जाएंगे और फिर हम सिर्फ एक नियमित शादी कर सकते हैं और हर कोई खुश होगा।
I've given it three years of thought. And I'd hope that if I waited, father would forget about Larry and then we could just have a regular wedding and everyone would be happy.	लेकिन अगर मैं यहां ऐसा नहीं कर सकता, तो मुझे कहीं और जाना पड़ सकता है।
But if I can't do that here, I may have to go somewhere else.	यह क्या बदतमीज़ी है?
What the hell is this?	मैं बाहर निकल जाऊंगा।मैं शादी कर लूंगा और मैं कहीं और जाऊंगा, शायद न्यूयॉर्क।
I'll get out. I'll get married and I'll move somewhere else, maybe New York.	क्या तुम पागल हो?
Are you crazy?	मैं बहुत लंबे समय से एक अच्छा बेटा रहा हूं, एक अच्छा चूसने वाला।
I've been a good son for too long, a good sucker.	आपका यहां एक व्यवसाय है।यह क्या बदतमीज़ी है?
You have a business here. What the hell is this?	व्यवसाय जिस?व्यवसाय मुझे प्रेरित नहीं करता है।
The business? The business doesn't inspire me.	ओह।क्या आपको प्रेरित होना चाहिए?
Oh. Must you be inspired?	हाँ।मुझे यह एक दिन में एक घंटे पसंद है।मुझे परवाह नहीं है अगर मुझे दिन भर पैसे के लिए ग्रब करना है, जब मैं घर आता हूं तो मैं इसे खुश करना चाहता हूं।
Yes. I like it for an hour a day. I don't care if I have to grub for money all day long, when I come home I want it happy.	मुझे कुछ बच्चे चाहिए, मुझे एक परिवार चाहिए, मैं चाहता हूं कि कोई ऐसा व्यक्ति जिसे मैं खुद दे सकूं और एनी उसी के केंद्र में हो।अब यह सिर्फ इसे खोजने के लिए है।
I want some kids, I want a family, I want somebody that I can give myself to and Annie is in the center of that. Now it's just where to find it.	आप मुझे बताने का मतलब है कि आप इस पर व्यवसाय छोड़ देंगे?
You mean to tell me that you would leave the business over this?	इस पर, मैं करूँगा।
On this, I would.	वैसे आप ऐसा नहीं सोचना चाहते।
Well you don't want to think like that.	फिर मुझे यहां रहने में मदद करें।
Then help me stay here.	ठीक है।लेकिन आप ऐसा नहीं सोचना चाहते हैं क्योंकि हम किस नरक के लिए काम कर रहे हैं, क्रिस?यह सब आप के लिए ही है।यह पूरा शूटिंग मैच आपके लिए है।
All right. But you don't want to think like that because what the hell are we working for, Chris? It's all for you. This whole shooting match is for you.	मुझे पता है कि।तो बस मुझे यहां रहने में मदद करें।
I know that. Then just help me stay here.	बस ऐसा मत सोचो।
Just don't think like that.	वैसे मैं ऐसा ही सोच रहा हूं।
Well I am thinking like that.	मैं तुम्हें नहीं समझता, क्या मैं?
I don't understand you, do I?	नहीं, आप नहीं।मैं बहुत सख्त आदमी हूँ।
No. You don't. I'm a pretty tough guy.	मैं देख सकता हूँ कि।
